{
  "id": "hard_3",
  "title": "Ромб",
  "difficulty": "hard",
  "width": 10,
  "height": 10,
  "solution": [
    [0, 0, 0, 0, 1, 1, 0, 0, 0, 0],
    [0, 0, 0, 1, 1, 1, 1, 0, 0, 0],
    [0, 0, 1, 1, 0, 0, 1, 1, 0, 0],
    [0, 1, 1, 0, 0, 0, 0, 1, 1, 0],
    [1, 1, 0, 0, 0, 0, 0, 0, 1, 1],
    [1, 1, 0, 0, 0, 0, 0, 0, 1, 1],
    [0, 1, 1, 0, 0, 0, 0, 1, 1, 0],
    [0, 0, 1, 1, 0, 0, 1, 1, 0, 0],
    [0, 0, 0, 1, 1, 1, 1, 0, 0, 0],
    [0, 0, 0, 0, 1, 1, 0, 0, 0, 0]
  ]
}
