{
  "id": "hard_4",
  "title": "Углы",
  "difficulty": "hard",
  "width": 10,
  "height": 10,
  "solution": [
    [1, 1, 1, 0, 0, 0, 0, 1, 1, 1],
    [1, 1, 1, 0, 0, 0, 0, 1, 1, 1],
    [1, 1, 1, 0, 0, 0, 0, 1, 1, 1],
    [0, 0, 0, 0, 0, 0, 0, 0, 0, 0],
    [0, 0, 0, 0, 1, 1, 0, 0, 0, 0],
    [0, 0, 0, 0, 1, 1, 0, 0, 0, 0],
    [0, 0, 0, 0, 0, 0, 0, 0, 0, 0],
    [1, 1, 1, 0, 0, 0, 0, 1, 1, 1],
    [1, 1, 1, 0, 0, 0, 0, 1, 1, 1],
    [1, 1, 1, 0, 0, 0, 0, 1, 1, 1]
  ]
}
